3111111111111431111111111114
2XXXXXXXXXXXX22XXXXXXXXXXXX2
2X3114X31114X22X31114X3114X2
2X6115X61115X65X61115X6115X2
2XXXXXXXXXXXXXXXXXXXXXXXXXX2
2X3114X34X31111114X34X3114X2
2X6115X22X61143115X22X6115X2
2XXXXXX22XXXX22XXXX22XXXXXX2
611114X26114X22X31152X311115
XXXXX2X23115X65X61142X2XXXXX
XXXXX2X22XXXXXXXXXX22X2XXXXX
XXXXX2X22X311XX114X22X2XXXXX
111115X65X2XXXXXX2X65X611111
XXXXXXXXXX2XXXXXX2XXXXXXXXXX
111114X34X2XXXXXX2X34X311111
XXXXX2X22X61111115X22X2XXXXX
XXXXX2X22XXXXXXXXXX22X2XXXXX
XXXXX2X22X31111114X22X2XXXXX
311115X65X61143115X65X611114
2XXXXXXXXXXXX22XXXXXXXXXXXX2
2X3114X31114X22X31114X3114X2
2X6142X61115X65X61115X2315X2
2XXX22XXXXXXXXXXXXXXXX22XXX2
614X22X34X31111114X34X22X315
315X65X22X61143115X22X65X614
2XXXXXX22XXXX22XXXX22XXXXXX2
2X3111156114X22X3115611114X2
2X6111111115X65X6111111115X2
2XXXXXXXXXXXXXXXXXXXXXXXXXX2
6111111111111111111111111115