0000000000000000000000000000
0XXXXXXXXXXXX00XXXXXXXXXXXX0
0X0000X00000X00X00000X0000X0
0X0000X00000X00X00000X0000X0
0XXXXXXXXXXXXXXXXXXXXXXXXXX0
0X0000X00X00000000X00X0000X0
0X0000X00X00000000X00X0000X0
0XXXXXX00XXXX00XXXX00XXXXXX0
000000X00000X00X00000X000000
XXXXX0X00000X00X00000X0XXXXX
XXXXX0X00XXXXXXXXXX00X0XXXXX
XXXXX0X00X000XX000X00X0XXXXX
000000X00X0XXXXXX0X00X000000
XXXXXXXXXX0XXXXXX0XXXXXXXXXX
000000X00X0XXXXXX0X00X000000
XXXXX0X00X00000000X00X0XXXXX
XXXXX0X00XXXXXXXXXX00X0XXXXX
XXXXX0X00X00000000X00X0XXXXX
000000X00X00000000X00X000000
0XXXXXXXXXXXX00XXXXXXXXXXXX0
0X0000X00000X00X00000X0000X0
0X0000X00000X00X00000X0000X0
0XXX00XXXXXXXXXXXXXXXX00XXX0
000X00X00X00000000X00X00X000
000X00X00X00000000X00X00X000
0XXXXXX00XXXX00XXXX00XXXXXX0
0X0000000000X00X0000000000X0
0X0000000000X00X0000000000X0
0XXXXXXXXXXXXXXXXXXXXXXXXXX0
0000000000000000000000000000